王宝强语出惊人，黄渤懵了！	王宝强诚实曝出, 鲁豫蒙圈了!
我不是王宝强	我不是潘金莲
世界杯假球论	世界杯有假球
10万买什么车比较好	10万左右买什么车好
阿胶糕多少钱一盒及图片欣赏	阿胶糕多少钱一盒
澳洲移民怎么办理	移民澳洲的条件
宝马车5系报价	华晨宝马汽车报价
北京装修哪家好	北京%20家装
笔记本电脑外接显示器技巧	笔记本接显示器
碧桂园森林城市房价	室内装修设计师
成都空调移机多少钱	成都空调移机多少钱
宠物小精灵xy手游	毛里求斯%20自由行
纯天然护肤品排行榜	天然化妆品品牌
戴隐形眼镜磨眼睛怎么办	戴隐形眼镜的方法
贷款买车哪种划算	买车贷款合适吗
二手车估价计算器	室内装修设计师
房地产中介好做吗	苹果6现在多少钱
海澜之家男装	海澜之家男装好吗
婚纱摄影前十名	沈阳会计上岗培训
快速致富的办法	赚钱最快的方法
脸上长癣怎么办	脸上长红血丝怎么办
买手机分期付款怎么付	手机分期分期付款
免费视频在线观看网站	免费视频在线观看
苹果7手机图片	苹果7手机价格
汽车音响改装接线图	奥迪汽车音响改装
汽车音响改装接线图	汽车音响改装线路
如何才能让脸变白	怎样可以让皮肤变白
